{
  "map_relevo": [
    [0, 0, 0, 0, 0, 0, 0, 0, 0, 0],
    [0, 0, 0, 0, 0, 0, 0, 0, 0, 0],
    [0, 0, 0, 0, 0, 0, 0, 0, 0, 0],
    [0, 0, 0, 0, 0, 0, 0, 0, 0, 0],
    [0, 0, 0, 0, 0, 0, 0, 0, 0, 0],
    [0, 0, 0, 0, 0, 0, 0, 0, 0, 0],
    [0, 0, 0, 0, 0, 0, 0, 0, 0, 0],
    [0, 0, 0, 0, 0, 0, 0, 0, 0, 0],
    [0, 0, 0, 0, 0, 0, 0, 0, 0, 0],
    [0, 0, 0, 0, 0, 0, 0, 0, 0, 0]
  ],
  "map_texture": [
    [0, 0, 0, 1, 0, 0, 0, 0, 0, 0],
    [0, 3, 3, 0, 0, 0, 0, 0, 0, 0],
    [1, 0, 1, 0, 1, 1, 1, 0, 0, 0],
    [1, 1, 1, 1, 0, 0, 0, 2, 0, 0],
    [0, 0, 1, 1, 1, 0, 1, 0, 0, 0],
    [0, 1, 0, 2, 2, 0, 0, 0, 0, 0],
    [1, 0, 3, 3, 0, 0, 0, 2, 0, null],
    [0, null, null, 0, 0, 0, 0, 0, 0, 0],
    [null, null, 1, 2, 0, 0, 2, null, null, null],
    [null, null, 0, 0, 0, null, 0, null, null, null]
  ]
}
